....................
....#..........#....
....#..........#....
....#..........#....
....#..........#....
....#..........#....
....############....
....................
....................
....................
..####.......###....
.........S..........
....................
....................
....................
